#####################
####   ##############
#### # ##############
#### #  #   #   #####
#       # $   $ #####
# ## #$ #   #   #   #
# $  #  ## ## $   $ #
# ## #####  #   #   #
# $   #  #  ##### ###
### $    @  ...## ###
###   #     ...## ###
#######  ###...## ###
#################   #
################# $ #
#################   #
#####################