######
#.   #
# $  #
#  @ #
######
