##########
#.       #
# $ $ $  #
#   @  $ #
#       .#
#  .   . #
##########
