########
#.     #
# $ $  #
#   @  #
#     .#
########
