########
#  .   #
# $ $  #
#  @   #
# .    #
########
