######
#.  #
# $ #
# @ #
######
