##########
#.  .   #
# $ $ $  #
#   @    #
#  .     #
##########
