#############
#.  .  .  .#
# $ $ $ $   #
#     @     #
#############
