#;#;#;#;# 
#; ;.; ;# 
#; ;$; ;#
#; ; ; ;# 
#; ;@; ;#
#;#;#;#;#
