#####
#   #
#$  #
#.  #
#$  #
#.  #
#   #
#   #
#   #
#   #
#   #
#   #
#@  #
#####
