##########
#.  .   #
# $ $   #
#  @    #
##########
