###########
#.  #  . #
# $ # $   #
#   @     #
###########
