#############
#. . . .   #
# $ $ $ $   #
#     @     #
#############
