##########
#@    .  #
#  .$ $  #
#.  $    #
#        #
#     $  #
#     .  #
##########