###########
#. . .   #
# $ $ $   #
#   @     #
###########
