#########
#.  #  .#
# $ # $ #
#   @   #
#########
