#######
#  .  #
# $ $ #
#  @  #
#  .  #
#######
