###########
#.  .  . #
# $ $ $   #
#    @    #
###########
