##########
#. . . .#
# $$ $$  #
#   @    #
##########
