#########
#.  .  .#
# $ $ $ #
#   @   #
#########
