#######
#.   .#
# $ $ #
#  @  #
#######
