##########
#. . .  #
# $ $ $ #
#   @   #
##########
