########
#.    .#
# $  $ #
#  @   #
########
