#######
#. . #
# $ $ #
#  @  #
#######
