#####
# . #
# $ #
#   #
# @ #
#####
