########
#  .   #
# $ $  #
#  @   #
#   .  #
########
