#############
#@          #
#           #
#   $$###$  #
#   #. . $  #
#  $#.$.#.  #
#   $$*     #
#  .#.$.#.  #
# # $...#   #
#   ###$$ # #
#           #
#############