#######
#.   #
# $  #
#  # #
# $  #
#.   #
# @  #
#######
