#############
#. . . .   ##
# $ $ $ $   #
#     @     #
#############
