##############
#. . . .    #
# $ $ $ $    #
#     @      #
##############
