##########
#. . . .##
# $$ $$  #
#   @    #
##########
