########
#. .  #
# $$  #
#  @  #
########
