###########
### @ #   #
# * $ *.. #
#   $ #   #
####*#  ###
##     ####
##   ######
###########