##############################
#####*#  #################  ##
#   ###                      #
#        ########  ####  ##  #
### ####     #  ####  ####  ##
#*# # .# # # #     #     #   #
#*# #  #     # ##  # ##  ##  #
###    ### ###  # ##  # ##  ##
##   # #*#      #     # #    #
##   # ###  #####  #### #    #
######   #####  ####### ######
##   # # #**#               ##
## # #   #**#  #######  ##  ##
#    #########  #    ##### ###
# #             # $        #*#
#   #########  ### @#####  #*#
##############################