##############
#      #     #
# $@$$ # . ..#
## ## ### ## #
## #       # #
## #   #   # #
## ######### #
##           #
##############