#######
#   ###
# . ###
#.@.###
##.#  #
#  $  #
# $   #
##$$  #
##  ###
##  ###
#######