###########
#   . .  @#
# ## $ ## #
#   .$.   #
# ## $$## #
#         #
###########