###############
###  ##########
###  ######   #
###  ######.# #
####  $    .  #
#   $$# ###.# #
#   #   # #   #
###########@ ##
###########  ##
###############