#########
##### #.#
#   ###.#
#   $ #.#
# $  $  #
#####@# #
#####   #
#########